2,0,3,1,4
1,4,2,3,0
3,1,0,4,2
4,2,1,0,3
0,3,4,2,1