4,3,2,1,3
3,0,2,0,2
2,4,1,2,4
4,0,3,0,2
4,2,4,1,3