4,4,1,3,3
2,0,4,0,1
2,4,3,2,3
1,0,1,0,2
2,1,3,2,4