4,2,2,4,3
2,0,2,0,1
4,3,4,2,1
3,0,4,0,3
1,4,3,2,1