4,4,3,1,1
3,0,1,0,4
2,1,3,2,3
1,0,2,0,4
4,1,3,4,2