2,3,1,1,1
2,0,2,0,4
3,2,4,4,3
2,0,1,0,2
4,4,2,3,4