4,4,4,1,3
3,0,2,0,3
4,1,3,1,4
3,0,3,0,4
2,4,3,1,2