2,2,3,4,1
1,0,2,0,3
3,1,3,2,3
3,0,1,0,4
4,3,2,4,3