2,4,2,4,4
3,0,3,0,3
1,4,2,2,1
1,0,1,0,3
3,3,4,3,4