2,4,1,4,4
4,0,2,0,3
3,2,2,4,4
3,0,4,0,2
2,4,2,1,2