4,1,4,2,1
2,0,2,0,4
1,3,1,2,2
4,0,4,0,3
4,2,3,4,2