1,4,1,0,3
4,3,4,4,1
2,0,1,1,2
4,2,4,0,3
2,3,1,2,4