1,3,2,0,3
4,3,1,4,3
2,0,4,1,2
4,3,4,0,1
2,3,2,3,4