1,2,3,0,1
3,1,4,2,4
4,0,2,1,3
2,1,4,0,1
3,1,3,4,3