4,2,2,0,4
4,1,4,1,3
3,0,3,2,3
3,3,4,0,4
1,4,1,2,2