3,1,2,0,3
1,4,4,3,1
2,0,2,2,3
4,1,3,0,1
4,2,4,2,3