1,2,1,0,1
3,4,3,3,4
4,0,1,1,2
2,1,3,0,4
4,3,2,1,1