2,1,1,0,2
4,4,3,1,3
3,0,2,4,4
1,3,1,0,3
4,2,2,1,3