3,2,3,0,4
4,3,2,4,1
1,0,3,1,2
3,1,3,0,4
2,3,1,4,1