3,4,1,0,1
4,3,2,4,2
3,0,4,3,1
2,4,2,0,4
4,3,1,2,2