0,0,1,0,0
0,4,2,4,0
2,3,1,3,1
0,1,3,4,0
0,0,2,0,0