0,0,2,0,0
0,1,4,1,0
4,3,2,3,4
0,1,4,1,0
0,0,2,0,0