0,0,2,0,0
0,1,3,4,0
2,4,1,2,1
0,3,2,4,0
0,0,4,0,0