0,0,4,0,0
0,4,3,2,0
4,2,1,4,1
0,3,4,2,0
0,0,2,0,0