0,0,4,0,0
0,1,2,1,0
1,3,4,3,2
0,1,3,1,0
0,0,2,0,0