0,0,2,0,0
0,4,1,3,0
2,3,3,4,1
0,4,2,4,0
0,0,1,0,0