0,0,4,0,0
0,3,2,4,0
1,2,4,3,1
0,3,1,4,0
0,0,4,0,0