0,0,4,0,0
0,3,2,3,0
1,2,4,1,2
0,4,2,3,0
0,0,1,0,0