4,0,0,0,2
2,0,2,4,0
3,4,2,0,0
2,0,3,1,0
1,0,0,0,4