4,0,0,0,1
2,0,4,2,0
3,1,2,0,0
2,0,4,2,0
3,0,0,0,4