2,0,0,0,1
4,0,1,4,0
2,4,1,0,0
1,0,4,2,0
1,0,0,0,2