3,0,0,0,4
1,0,3,4,0
4,4,1,0,0
2,0,4,4,0
4,0,0,0,3