0,2,0,4,0
4,3,1,4,2
0,3,0,3,0
1,4,1,2,1
0,1,0,3,0