0,3,0,3,0
1,4,3,1,3
0,4,0,2,0
2,3,4,1,2
0,1,0,3,0