0,3,0,3,0
3,1,2,1,4
0,2,0,4,0
1,3,4,1,1
0,1,0,3,0