0,4,0,1,0
3,2,4,3,3
0,4,0,1,0
2,1,2,2,1
0,4,0,1,0