0,3,0,1,0
1,4,3,2,1
0,2,0,3,0
1,3,2,4,2
0,2,0,1,0