0,2,0,1,0
2,3,3,4,1
0,2,0,2,0
3,1,3,4,2
0,1,0,3,0