0,2,0,1,0
2,1,3,2,4
0,2,0,4,0
3,1,4,2,1
0,2,0,3,0