0,1,0,1,0
4,2,3,4,2
0,1,0,2,0
4,1,2,1,3
0,2,0,3,0