0,3,0,2,0
1,4,2,3,2
0,3,0,2,0
2,4,1,4,1
0,4,0,4,0