0,3,0,3,0
4,1,2,4,4
0,4,0,1,0
4,2,4,3,1
0,3,0,1,0