4,0,2,1,3
2,3,1,4,1
3,1,4,0,3
0,2,1,2,3
1,4,2,4,0