4,0,1,1,4
1,4,3,4,2
2,4,1,0,4
0,2,4,1,3
4,4,1,2,0