1,0,4,1,3
4,2,3,4,2
2,3,1,0,4
0,4,2,1,2
3,2,1,4,0