4,0,2,4,4
3,4,4,2,3
2,3,2,0,2
0,1,1,4,2
1,3,4,1,0