2,0,4,4,2
1,3,3,1,1
3,4,3,0,2
0,1,4,2,4
1,4,3,4,0