4,0,4,1,2
1,2,1,2,1
4,3,4,0,3
0,4,3,3,4
1,3,1,1,0