2,0,4,2,1
1,3,3,1,4
2,4,1,0,2
0,2,3,2,4
3,4,1,2,0