1,0,4,1,4
2,1,1,4,2
1,3,2,0,2
0,4,3,1,4
3,3,2,1,0