4,0,4,3,1
3,2,3,1,4
2,1,4,0,2
0,4,1,2,4
1,2,1,3,0