4,0,3,4,2
1,4,1,3,1
3,1,4,0,2
0,2,1,4,4
4,1,3,2,0