4,2,3,4,3
0,1,2,4,0
0,0,3,0,0
0,1,4,1,0
2,3,4,4,3