3,1,0,4,2
4,2,3,0,1
1,0,4,2,3
2,4,1,3,0
0,3,2,1,4