4,3,4,2,3
0,3,2,1,0
0,0,3,0,0
0,2,3,1,0
1,1,1,3,4