3,4,2,2,1
0,4,3,3,0
0,0,1,0,0
0,1,3,4,0
3,3,4,1,1