2,3,4,4,2
0,3,3,2,0
0,0,1,0,0
0,2,4,1,0
2,1,2,4,2