4,2,2,1,1
0,3,4,2,0
0,0,1,0,0
0,3,2,4,0
1,4,4,1,4