3,4,1,3,1
0,2,4,1,0
0,0,2,0,0
0,4,1,3,0
1,4,2,1,2