1,4,2,4,3
0,3,4,1,0
0,0,4,0,0
0,3,4,3,0
1,2,4,1,2