2,3,3,4,2
0,4,3,4,0
0,0,3,0,0
0,3,4,1,0
2,1,2,4,1