3,4,3,2,4
0,2,4,3,0
0,0,2,0,0
0,1,1,3,0
4,1,1,2,3