3,2,4,3,2
0,4,3,1,0
0,0,4,0,0
0,4,1,2,0
1,2,2,3,3