0,3,0,2,0
4,2,3,1,4
2,1,4,4,3
0,4,3,2,0
0,0,2,0,0