0,4,0,2,0
1,2,4,3,4
2,4,3,1,3
0,3,4,2,0
0,0,3,0,0