0,1,0,3,0
3,3,2,4,1
1,2,3,1,2
0,3,2,4,0
0,0,1,0,0