0,4,0,4,0
3,2,3,2,2
4,4,3,3,3
0,2,1,2,0
0,0,4,0,0