0,4,0,3,0
1,3,4,4,2
3,2,3,2,4
0,1,3,4,0
0,0,2,0,0