0,2,0,4,0
3,4,1,2,1
2,1,4,4,4
0,2,3,1,0
0,0,1,0,0