0,2,0,1,0
4,3,4,1,4
3,4,1,4,3
0,2,3,1,0
0,0,3,0,0