0,1,0,3,0
3,3,1,3,2
2,1,3,4,4
0,4,1,3,0
0,0,1,0,0