0,1,0,3,0
3,2,3,4,3
2,4,2,3,2
0,2,1,4,0
0,0,4,0,0