4,2,1,3,2
2,4,4,2,1
3,2,0,1,2
3,3,1,4,3
1,2,4,1,4