2,1,2,4,3
1,3,1,3,4
2,1,0,4,1
4,2,1,2,4
3,4,3,4,1