3,1,4,1,4
2,4,2,4,3
3,4,0,2,1
2,3,3,4,2
1,1,4,1,1