1,2,4,3,1
3,4,2,3,2
1,4,0,4,3
4,2,4,1,1
1,4,2,4,3