3,2,3,4,2
4,3,2,3,1
1,2,0,1,4
4,3,4,2,1
3,1,2,1,3