4,2,1,3,4
1,1,2,4,3
2,3,0,2,1
1,1,2,4,3
3,2,4,2,1