3,2,4,3,4
4,3,1,4,1
1,4,0,1,4
2,1,1,4,2
3,2,3,2,3