3,1,3,1,3
4,2,1,3,2
3,2,0,2,4
4,3,1,1,3
1,2,4,3,2