3,4,3,2,4
2,3,1,3,2
4,2,0,4,4
1,4,3,1,2
3,1,4,3,4