3,1,4,1,3
1,4,2,4,2
2,4,0,1,4
1,3,2,3,2
4,1,3,4,4