2,3,0,1,2
4,2,0,2,3
0,0,0,0,0
2,1,0,2,4
1,3,0,4,3