4,2,0,2,1
2,4,0,1,3
0,0,0,0,0
4,2,0,4,3
3,4,0,1,2