3,1,0,3,1
4,2,0,1,4
0,0,0,0,0
4,1,0,4,3
1,3,0,2,4