4,3,0,1,3
2,4,0,3,2
0,0,0,0,0
2,3,0,4,4
4,3,0,1,3