4,4,0,1,4
2,3,0,4,1
0,0,0,0,0
3,1,0,4,3
3,2,0,4,1