3,2,0,2,3
2,1,0,4,2
0,0,0,0,0
4,2,0,3,1
2,4,0,3,4