4,2,0,3,4
2,4,0,2,1
0,0,0,0,0
1,4,0,1,2
3,1,0,4,1