2,3,0,2,1
1,4,0,4,2
0,0,0,0,0
3,2,0,1,4
2,4,0,3,4