1,2,0,1,3
4,2,0,4,2
0,0,0,0,0
3,2,0,2,4
1,4,0,1,2