2,4,0,3,4
3,1,0,1,3
0,0,0,0,0
1,4,0,2,1
4,2,0,1,4